NO ./path_to_the_north_texture/folder/file
SO ./path_to_the_south_texture/file
WE ./path_to_the_west_texture/folder/folder/file
EA ./path_to_the_east_texture/file

F 220,100,0


1111111111111111111111111
1000000000110000000000001
1011000001110000000000001
1001000000000000000000001
10110000011100000000000N1
1100000111011111111111111
1111011111111101110000001
1111011111111101110101001
1100000011010101110000001
1000000000000000110000001
1000000000000000110101001
1100000111010101111101111
11110111 1110101 10111101
11111111 1111111 11111111

C 240,30,0