WE ./textures/mossy.png
NO ./textures/wood.png
SO ./textures/mossy.png
EA ./textures/wood.png

F 220,100,0
C 240,30,0


11111111111111111111111111111111111111111111111111
10000000100001000010001001100001000000000000010001
10000000000011010100100000001110001011111100000011
11000101000100011000011000010101101001011110100001
10000110000111000010100110010000000100111011000101
10000100101010011001000000000010000000110010100011
10011011010001100010100000011000110100000100001111
10000100000000010000000110100000111010100010100001
10100000000100101000001010110000001110100001101001
11001000000000010000100110110000000100000001000001
10110000111100000100000100001101010100010111111011
10110001001110100100010000000001101100111011001001
101000000110000101010000001010000011110001100000W1
10000001101000010010000011000100010101000001100101
10001010100000001000100010100000001100000101000001
11000001000000000000000100100000111011000000010011
11100000000001000010100001010100011000100000001001
10000110000000100000000100000100010001100100101001
11011001010011111000000010101000000001000100010101
11111111111111111111111111111111111111111111111111


