WE ./textures/redbrick.png
NO ./textures/brickwall2.png
SO ./textures/greystone.png
EA ./textures/eagle.png

F 255,255,255
C 0,0,0

11111111
10000001
10110001
10010001
1110W001
10000001
11111111