NO ./textures/brickwall2.png
SO ./textures/greystone.png
WE ./textures/redbrick.png
EA ./textures/eagle.png

F 255,255,255
C 0,0,0

11111111111111111111
10000000001100100001
10110000011100000001
10010000000000000001
111000001101100000E1
10000000000000000001
11111111111111111111


