1111111111111111111111111
1000N00000110000000000001
1011000001110000000000001
1001000000000000000000001
1111111111111111111111111