NO ./path_to_the_north_texture/folder/file
SO ./path_to_the_south_texture/file
WE ./path_to_the_west_texture/folder/folder/file
EA ./path_to_the_east_texture/file

F 220,100,0
C 240,30,0

11111111111111111111
10000000001100100001
10110000011100000001
10010000000000000001
111000001101100000N1
10000000000000000001
11111111111111111111